11111111111111111111
10010000000000001001
10000000000000000001
11000000000000000011
1v00000C000000000001
10000000000000000001
10000P000000E0000001
10000000000000000001
10000000000000000001
11000000000000000011
10000000000000000001
10010000000000001001
11111111111111111111
