11111111111111
100100000L1001
10000000000001
11000000000011
1000000C0000D1
10000000000001
10000000000001
10000000000001
10000000000001
1U000PE0000001
110000C0000011
10000000000001
1001R000001001
11111111111111
