1111111
100C1P1
1000001
1E11111
1111111
