11111111111111111
11000000111000001
11010011100010011
10010111001100111
10110101011111111
11110000001111111
10000000000000001
10100000001110111
10100000001100111
11000000001101111
1P0000000011000E1
11111111111111111