11111111111111111
1100000C1110000C1
11010011100010011
100101110011C0111
1C110101011111111
11110000001111111
10000000000000001
10100000001110111
1C100000001100111
11000C00001111111
1P0000000011000E1
11111111111111111